Decision Tree Model Accuracy : 0.89% 
+-------------+----------+------------+-----------+
| precision   | recall   |   f1-score |   support |
+=============+==========+============+===========+
|             |          |            |           |
+-------------+----------+------------+-----------+
| BARBUNYA    | 0.87     |       0.85 |      0.86 |
+-------------+----------+------------+-----------+
| BOMBAY      | 1.00     |       1    |      1    |
+-------------+----------+------------+-----------+
| CALI        | 0.87     |       0.91 |      0.89 |
+-------------+----------+------------+-----------+
| DERMASON    | 0.89     |       0.88 |      0.88 |
+-------------+----------+------------+-----------+
| HOROZ       | 0.96     |       0.92 |      0.94 |
+-------------+----------+------------+-----------+
| SEKER       | 0.93     |       0.91 |      0.92 |
+-------------+----------+------------+-----------+
| SIRA        | 0.82     |       0.85 |      0.83 |
+-------------+----------+------------+-----------+
|             |          |            |           |
+-------------+----------+------------+-----------+
| accuracy    | 0.89     |    2723    |           |
+-------------+----------+------------+-----------+
| macro       | avg      |       0.9  |      0.9  |
+-------------+----------+------------+-----------+
| weighted    | avg      |       0.89 |      0.89 |
+-------------+----------+------------+-----------+
|             |          |            |           |
+-------------+----------+------------+-----------+