K-NN Model Accuracy : 0.92% 
+-------------+----------+------------+-----------+
| precision   | recall   |   f1-score |   support |
+=============+==========+============+===========+
|             |          |            |           |
+-------------+----------+------------+-----------+
| BARBUNYA    | 0.93     |       0.89 |      0.91 |
+-------------+----------+------------+-----------+
| BOMBAY      | 1.00     |       1    |      1    |
+-------------+----------+------------+-----------+
| CALI        | 0.91     |       0.94 |      0.93 |
+-------------+----------+------------+-----------+
| DERMASON    | 0.89     |       0.92 |      0.9  |
+-------------+----------+------------+-----------+
| HOROZ       | 0.98     |       0.94 |      0.96 |
+-------------+----------+------------+-----------+
| SEKER       | 0.98     |       0.95 |      0.96 |
+-------------+----------+------------+-----------+
| SIRA        | 0.85     |       0.86 |      0.86 |
+-------------+----------+------------+-----------+
|             |          |            |           |
+-------------+----------+------------+-----------+
| accuracy    | 0.92     |    2723    |           |
+-------------+----------+------------+-----------+
| macro       | avg      |       0.93 |      0.93 |
+-------------+----------+------------+-----------+
| weighted    | avg      |       0.92 |      0.92 |
+-------------+----------+------------+-----------+
|             |          |            |           |
+-------------+----------+------------+-----------+