Random Forest Model Accuracy : 0.93% 
+-------------+----------+------------+-----------+
| precision   | recall   |   f1-score |   support |
+=============+==========+============+===========+
|             |          |            |           |
+-------------+----------+------------+-----------+
| BARBUNYA    | 0.93     |       0.89 |      0.91 |
+-------------+----------+------------+-----------+
| BOMBAY      | 1.00     |       1    |      1    |
+-------------+----------+------------+-----------+
| CALI        | 0.93     |       0.94 |      0.93 |
+-------------+----------+------------+-----------+
| DERMASON    | 0.90     |       0.93 |      0.91 |
+-------------+----------+------------+-----------+
| HOROZ       | 0.97     |       0.96 |      0.97 |
+-------------+----------+------------+-----------+
| SEKER       | 0.97     |       0.94 |      0.95 |
+-------------+----------+------------+-----------+
| SIRA        | 0.88     |       0.88 |      0.88 |
+-------------+----------+------------+-----------+
|             |          |            |           |
+-------------+----------+------------+-----------+
| accuracy    | 0.93     |    2723    |           |
+-------------+----------+------------+-----------+
| macro       | avg      |       0.94 |      0.93 |
+-------------+----------+------------+-----------+
| weighted    | avg      |       0.93 |      0.93 |
+-------------+----------+------------+-----------+
|             |          |            |           |
+-------------+----------+------------+-----------+