SVC Model Accuracy : 0.93% 
+-------------+----------+------------+-----------+
| precision   | recall   |   f1-score |   support |
+=============+==========+============+===========+
|             |          |            |           |
+-------------+----------+------------+-----------+
| BARBUNYA    | 0.94     |       0.92 |      0.93 |
+-------------+----------+------------+-----------+
| BOMBAY      | 1.00     |       1    |      1    |
+-------------+----------+------------+-----------+
| CALI        | 0.94     |       0.95 |      0.95 |
+-------------+----------+------------+-----------+
| DERMASON    | 0.91     |       0.93 |      0.92 |
+-------------+----------+------------+-----------+
| HOROZ       | 0.98     |       0.96 |      0.97 |
+-------------+----------+------------+-----------+
| SEKER       | 0.97     |       0.95 |      0.96 |
+-------------+----------+------------+-----------+
| SIRA        | 0.88     |       0.89 |      0.89 |
+-------------+----------+------------+-----------+
|             |          |            |           |
+-------------+----------+------------+-----------+
| accuracy    | 0.93     |    2723    |           |
+-------------+----------+------------+-----------+
| macro       | avg      |       0.95 |      0.94 |
+-------------+----------+------------+-----------+
| weighted    | avg      |       0.93 |      0.93 |
+-------------+----------+------------+-----------+
|             |          |            |           |
+-------------+----------+------------+-----------+