 Adaptive Boosting Model Accuracy : 0.63% 
+-------------+----------+------------+-----------+
| precision   | recall   |   f1-score |   support |
+=============+==========+============+===========+
|             |          |            |           |
+-------------+----------+------------+-----------+
| BARBUNYA    | 0.00     |       0    |      0    |
+-------------+----------+------------+-----------+
| BOMBAY      | 0.00     |       0    |      0    |
+-------------+----------+------------+-----------+
| CALI        | 0.48     |       0.99 |      0.64 |
+-------------+----------+------------+-----------+
| DERMASON    | 0.62     |       0.94 |      0.74 |
+-------------+----------+------------+-----------+
| HOROZ       | 0.94     |       0.71 |      0.81 |
+-------------+----------+------------+-----------+
| SEKER       | 0.96     |       0.2  |      0.33 |
+-------------+----------+------------+-----------+
| SIRA        | 0.76     |       0.76 |      0.76 |
+-------------+----------+------------+-----------+
|             |          |            |           |
+-------------+----------+------------+-----------+
| accuracy    | 0.63     |    2723    |           |
+-------------+----------+------------+-----------+
| macro       | avg      |       0.54 |      0.51 |
+-------------+----------+------------+-----------+
| weighted    | avg      |       0.65 |      0.63 |
+-------------+----------+------------+-----------+
|             |          |            |           |
+-------------+----------+------------+-----------+