LOGIT Model Accuracy : 0.93% 
+-------------+----------+------------+-----------+
| precision   | recall   |   f1-score |   support |
+=============+==========+============+===========+
|             |          |            |           |
+-------------+----------+------------+-----------+
| BARBUNYA    | 0.92     |       0.92 |      0.92 |
+-------------+----------+------------+-----------+
| BOMBAY      | 1.00     |       1    |      1    |
+-------------+----------+------------+-----------+
| CALI        | 0.95     |       0.94 |      0.94 |
+-------------+----------+------------+-----------+
| DERMASON    | 0.92     |       0.91 |      0.91 |
+-------------+----------+------------+-----------+
| HOROZ       | 0.97     |       0.97 |      0.97 |
+-------------+----------+------------+-----------+
| SEKER       | 0.97     |       0.94 |      0.96 |
+-------------+----------+------------+-----------+
| SIRA        | 0.86     |       0.9  |      0.88 |
+-------------+----------+------------+-----------+
|             |          |            |           |
+-------------+----------+------------+-----------+
| accuracy    | 0.93     |    2723    |           |
+-------------+----------+------------+-----------+
| macro       | avg      |       0.94 |      0.94 |
+-------------+----------+------------+-----------+
| weighted    | avg      |       0.93 |      0.93 |
+-------------+----------+------------+-----------+
|             |          |            |           |
+-------------+----------+------------+-----------+